#domain
hospital
#levelname
SAtest
#colors
red: 0, A
blue: 1, B
#initial
+++++++++++++++++++++++++++
+ 0  1B                   +
+ AB                      +
+++++++++++++++++++++++++++
#goal
+++++++++++++++++++++++++++
+                         +
+    0 1                  +
+++++++++++++++++++++++++++
#end