#domain
hospital
#levelname
SAtest
#colors
red: 0, A
blue: B
#initial
+++++++++++++++++++++++++++
+ 0                       +
+ AB                      +
+++++++++++++++++++++++++++
#goal
+++++++++++++++++++++++++++
+                         +
+     A                   +
+++++++++++++++++++++++++++
#end
