#domain
hospital
#levelname
SAtest
#colors
red: 0, A
blue: 1, B
#initial
+++++++++++++++++++++++++++
+ 1      0A               +
+  A                      +
+++++++++++++++++++++++++++
#goal
+++++++++++++++++++++++++++
+    A                    +
+ 1        A              +
+++++++++++++++++++++++++++
#end
